....................
...#####............
...#...#...#...#....
...#...####....#....
...............###..
....................
#..........##.......
##.........#........
####................
...###..............
....................
....................
#..#.......##.###...
..........#.....#...
..#####.........#...
..#...##.......#...
..#.................
..#.......#..##.....
..###.....#...#.....
....................